SO ./images/cube.png

WE     ./images/cube.png

EA ./images/cube.png

C 10,10,10
F                          10,10,123


           NO ./images/cube.png

         



11111111111111111111111111111111111
10000000000000000000000000000000111
10000000000100000000000111000000111
10001000000100000000001111100000111
10000000011000000000001111100000111
10000000000000000000001111100000111
100000W0000000000000011111000001111
11111111111111111111111111111111111